		11111111
1111111100000001
1000000000000001
1000000000000001
1111111111111111
