NO ./textures/wall1
SO ./textures/wall2
WE ./textures/wall3
EA ./textures/wall4

F 220,100,0
C 225,30,0

		11111111
1111111100000001
1000000000000001
1000000000000001
1111111111111111
