NO ./textures/wall1.xpm
SO ./textures/wall2.xpm
WE ./textures/wall3.xpm
EA ./textures/wall4.xpm

F 220,100,0
C 225,30,0

1111111111
100000000
100000N001
1000000001
1111111111