NO ./textures/wall1
SO ./textures/wall2
WE ./textures/wall3
EA ./textures/wall4

F 220,100,0
C 225,30,0

11111111111
111111111111
110000000011
11001000011
11N00100011
111111100011
     1100011
     1111111
     111111